WWWWWWWWWWWWWWWWWWWW
W P   W  K B    W AW
W     WWWWWW    W  W
WWWW               W
W                  W
WWWWWWWWWWWWWWWW   W 
L   C W      W     W 
W  W  WWW   WWWW   W     
L WW  W    E W     W
W            W     W     
W    WWWW          W 
W       W       WW W     
W  W    WWWW    W  W     
WS  WG  W       W          
WWWWWWWWWWWWWWWWWWWW