WWWWWWWWWWWWWWWWWWW
WL                W
W   C    WW       W  
W   W    WWWWWWWWWW  
W   W             W  
W   W        WWWWWW  
W       E         W  
W          W      W  
WL         W      W  
WWWWW             W  
W   W          WWWW  
W   W      W      W  
WWWWW      W  L   W  
WD         WL     W  
WWWWWWWWWWWWWWWWWWW